28,100
####################################################################################################
#                                                                                                  #
#                                                                                                  #
#           #       #                                                                              #
#           #       #                                                                              #
#           #       #                                                                              #
#           #       #                                                                #             #
#           #       #                                                                #             #
#           #       #                                                                #             #
#           #       #                                              ###################             #
#       #####       ##########                                                       #             @
#                                                                                    #             @
#                                                                                    #             #
#       ###################################                                          #             #
#                 #      #                                                           #             #
#                 #      #                                                           #             #
#                 #      #                                         ###################             #
#                 #      #                                                           #             #
#                 #      #                                                           #             #
#                 #      #                                                           #             #
#                 #      #                                                           #             #
#                 #      #                                                                         #
#                 #      #                                                                         #
#                                                                                                  #
#                                                                                                  #
#                                                                                                  #
#                                                                                                  #
####################################################################################################
20,2